_______________________________________
_______________________________________
______T________________________________
________________BBBBHHBB___BBBBBBBBB___
________________HHHHHHHH___BBBBBBBBB___
___B_B_B_B________BBHHBB___BBBBBBBBB___
___1_2_3_4_________T___________________
_______________________________________
______S________________________________
_________T_________________BBBBBBBBB___
__BB1___BB3________________BBBBBBBBB___
___________________________BBBBBBBBB___
__BB2___BB4____________________________
_______________________________________
_______________________________________
___BBBBBBBBB___BBBBBBBBB___BBBHHHBBB___
___BBBBBBBBB___BBBBBBBBB___BBBHHHBBB___
___BBBBBBBBB___BBBBBBBBB___BBBHHHBBB___
_______________________________________
_______________________________________
_______________________________________