________________
_BB__BB___B__BB_
_BB_______B__BB_
______F______HH_
_____________HH_
_BB______BB__BB_
_BB__BB__BB__BB_
_____BB_________
________________
_BHHHB__________
_BHHHB__________
_BHHHB__________