HHHHHHHHHHHHHHHHHHHHHHHHHHHHHHHHHHHHHHHHHHHHHHHHHHHHHHHHHHHHHHHHHHHHHHHHHHHHHHHHHHHHHH
HH______F________T__________________________________________________________________HH
HH__________________________________________________________________________________HH
HH__HH__HH__HH__HH__HH__HH__HH__HH__HH__HH__HH__HH__HH__HH__HH__HH__HH__HH__HH__HH__HH
HH__________________________________________________________________________________HH
HH__________________________________________________________________________________HH
HH__HH__HH__HH__HH__HH__HH__HH__HH__HH__HH__HH__HH__HH__HH__HH__HH__HH__HH__HH__HH__HH
HH__________________________________________________________________________________HH
HH__________________________________________________________________________________HH
HH__HH__HH__HH__HH__HH__HH__HH__HH__HH__HH__HH__HH__HH__HH__HH__HH__HH__HH__HH__HH__HH
HH__________________________________________________________________________________HH
HH__________________________________________________________________________________HH
HH__HH__HH__HH__HH__HH__HH__HH__HH__HH__HH__HH__HH__HH__HH__HH__HH__HH__HH__HH__HH__HH
HH__________________________________________________________________________________HH
HH__________________________________________________________________________________HH
HH__HH__HH__HH__HH__HH__HH__HH__HH__HH__HH__HH__HH__HH__HH__HH__HH__HH__HH__HH__HH__HH
HH__________________________________________________________________________________HH
HH__________________________________________________________________________________HH
HH__HH__HH__HH__HH__HH__HH__HH__HH__HH__HH__HH__HH__HH__HH__HH__HH__HH__HH__HH__HH__HH
HH__________________________________________________________________________________HH
HH__________________________________________________________________________________HH
HH__HH__HH__HH__HH__HH__HH__HH__HH__HH__HH__HH__HH__HH__HH__HH__HH__HH__HH__HH__HH__HH
HH__________________________________________________________________________________HH
HH__________________________________________________________________________________HH
HH__HH__HH__HH__HH__HH__HH__HH__HH__HH__HH__HH__HH__HH__HH__HH__HH__HH__HH__HH__HH__HH
HH__________________________________________________________________________________HH
HH__________________________________________________________________________________HH
HH__HH__HH__HH__HH__HH__HH__HH__HH__HH__HH__HH__HH__HH__HH__HH__HH__HH__HH__HH__HH__HH
HH__________________________________________________________________________________HH
HH__________________________________________________________________________________HH
HH__HH__HH__HH__HH__HH__HH__HH__HH__HH__HH__HH__HH__HH__HH__HH__HH__HH__HH__HH__HH__HH
HH__________________________________________________________________________________HH
HH__________________________________________________________________________________HH
HH__HH__HH__HH__HH__HH__HH__HH__HH__HH__HH__HH__HH__HH__HH__HH__HH__HH__HH__HH__HH__HH
HH__________________________________________________________________________________HH
HH__________________________________________________________________________________HH
HH__HH__HH__HH__HH__HH__HH__HH__HH__HH__HH__HH__HH__HH__HH__HH__HH__HH__HH__HH__HH__HH
HH__________________________________________________________________________________HH
HH__________________________________________________________________________________HH
HH__HH__HH__HH__HH__HH__HH__HH__HH__HH__HH__HH__HH__HH__HH__HH__HH__HH__HH__HH__HH__HH
HH__________________________________________________________________________________HH
HH__________________________________________________________________________________HH
HH__HH__HH__HH__HH__HH__HH__HH__HH__HH__HH__HH__HH__HH__HH__HH__HH__HH__HH__HH__HH__HH
HH__________________________________________________________________________________HH
HH__________________________________________________________________________________HH
HH__HH__HH__HH__HH__HH__HH__HH__HH__HH__HH__HH__HH__HH__HH__HH__HH__HH__HH__HH__HH__HH
HH__________________________________________________________________________________HH
HH__________________________________________________________________________________HH
HH__HH__HH__HH__HH__HH__HH__HH__HH__HH__HH__HH__HH__HH__HH__HH__HH__HH__HH__HH__HH__HH
HH__________________________________________________________________________________HH
HH__________________________________________________________________________________HH
HH__HH__HH__HH__HH__HH__HH__HH__HH__HH__HH__HH__HH__HH__HH__HH__HH__HH__HH__HH__HH__HH
HH__________________________________________________________________________________HH
HH__________________________________________________________________________________HH
HH__HH__HH__HH__HH__HH__HH__HH__HH__HH__HH__HH__HH__HH__HH__HH__HH__HH__HH__HH__HH__HH
HH__________________________________________________________________________________HH
HH__________________________________________________________________________________HH
HH__HH__HH__HH__HH__HH__HH__HH__HH__HH__HH__HH__HH__HH__HH__HH__HH__HH__HH__HH__HH__HH
HH__________________________________________________________________________________HH
HH__________________________________________________________________________________HH
HH__HH__HH__HH__HH__HH__HH__HH__HH__HH__HH__HH__HH__HH__HH__HH__HH__HH__HH__HH__HH__HH
HH__________________________________________________________________________________HH
HH__________________________________________________________________________________HH
HH__HH__HH__HH__HH__HH__HH__HH__HH__HH__HH__HH__HH__HH__HH__HH__HH__HH__HH__HH__HH__HH
HH__________________________________________________________________________________HH
HH__________________________________________________________________________________HH
HH__HH__HH__HH__HH__HH__HH__HH__HH__HH__HH__HH__HH__HH__HH__HH__HH__HH__HH__HH__HH__HH
HH__________________________________________________________________________________HH
HH__________________________________________________________________________________HH
HH__HH__HH__HH__HH__HH__HH__HH__HH__HH__HH__HH__HH__HH__HH__HH__HH__HH__HH__HH__HH__HH
HH__________________________________________________________________________________HH
HH__________________________________________________________________________________HH
HH__HH__HH__HH__HH__HH__HH__HH__HH__HH__HH__HH__HH__HH__HH__HH__HH__HH__HH__HH__HH__HH
HH__________________________________________________________________________________HH
HH__________________________________________________________________________________HH
HH__HH__HH__HH__HH__HH__HH__HH__HH__HH__HH__HH__HH__HH__HH__HH__HH__HH__HH__HH__HH__HH
HH__________________________________________________________________________________HH
HH__________________________________________________________________________________HH
HH__HH__HH__HH__HH__HH__HH__HH__HH__HH__HH__HH__HH__HH__HH__HH__HH__HH__HH__HH__HH__HH
HH__________________________________________________________________________________HH
HH__________________________________________________________________________________HH
HH__HH__HH__HH__HH__HH__HH__HH__HH__HH__HH__HH__HH__HH__HH__HH__HH__HH__HH__HH__HH__HH
HH__________________________________________________________________________________HH
HH__________________________________________________________________________________HH
HHHHHHHHHHHHHHHHHHHHHHHHHHHHHHHHHHHHHHHHHHHHHHHHHHHHHHHHHHHHHHHHHHHHHHHHHHHHHHHHHHHHHH