BBBBBBBBBBBBBBBBBBBBBBBBBBBBBBBBBBBBBBBBBBBBBBBBBBBBBBBBBBBBBBBBBBBBBBBBBBBBBBBBBBBBBB
________F________T__________________________________________________________________BB
____________________________________________________________________________________BB
BB__BB__BB__BB__BB__BB__BB__BB__BB__BB__BB__BB__BB__BB__BB__BB__BB__BB__BB__BB__BB__BB
BB__________________________________________________________________________________BB
BB__________________________________________________________________________________BB
BB__BB__BB__BB__BB__BB__BB__BB__BB__BB__BB__BB__BB__BB__BB__BB__BB__BB__BB__BB__BB__BB
BB__________________________________________________________________________________BB
BB__________________________________________________________________________________BB
BB__BB__BB__BB__BB__BB__BB__BB__BB__BB__BB__BB__BB__BB__BB__BB__BB__BB__BB__BB__BB__BB
BB__________________________________________________________________________________BB
BB__________________________________________________________________________________BB
BB__BB__BB__BB__BB__BB__BB__BB__BB__BB__BB__BB__BB__BB__BB__BB__BB__BB__BB__BB__BB__BB
BB__________________________________________________________________________________BB
BB__________________________________________________________________________________BB
BB__BB__BB__BB__BB__BB__BB__BB__BB__BB__BB__BB__BB__BB__BB__BB__BB__BB__BB__BB__BB__BB
BB__________________________________________________________________________________BB
BB__________________________________________________________________________________BB
BB__BB__BB__BB__BB__BB__BB__BB__BB__BB__BB__BB__BB__BB__BB__BB__BB__BB__BB__BB__BB__BB
BB__________________________________________________________________________________BB
BB__________________________________________________________________________________BB
BB__BB__BB__BB__BB__BB__BB__BB__BB__BB__BB__BB__BB__BB__BB__BB__BB__BB__BB__BB__BB__BB
BB__________________________________________________________________________________BB
BB__________________________________________________________________________________BB
BB__BB__BB__BB__BB__BB__BB__BB__BB__BB__BB__BB__BB__BB__BB__BB__BB__BB__BB__BB__BB__BB
BB__________________________________________________________________________________BB
BB__________________________________________________________________________________BB
BB__BB__BB__BB__BB__BB__BB__BB__BB__BB__BB__BB__BB__BB__BB__BB__BB__BB__BB__BB__BB__BB
BB__________________________________________________________________________________BB
BB__________________________________________________________________________________BB
BB__BB__BB__BB__BB__BB__BB__BB__BB__BB__BB__BB__BB__BB__BB__BB__BB__BB__BB__BB__BB__BB
BB__________________________________________________________________________________BB
BB__________________________________________________________________________________BB
BB__BB__BB__BB__BB__BB__BB__BB__BB__BB__BB__BB__BB__BB__BB__BB__BB__BB__BB__BB__BB__BB
BB__________________________________________________________________________________BB
BB__________________________________________________________________________________BB
BB__BB__BB__BB__BB__BB__BB__BB__BB__BB__BB__BB__BB__BB__BB__BB__BB__BB__BB__BB__BB__BB
BB__________________________________________________________________________________BB
BB__________________________________________________________________________________BB
BB__BB__BB__BB__BB__BB__BB__BB__BB__BB__BB__BB__BB__BB__BB__BB__BB__BB__BB__BB__BB__BB
BB__________________________________________________________________________________BB
BB__________________________________________________________________________________BB
BB__BB__BB__BB__BB__BB__BB__BB__BB__BB__BB__BB__BB__BB__BB__BB__BB__BB__BB__BB__BB__BB
BB__________________________________________________________________________________BB
BB__________________________________________________________________________________BB
BB__BB__BB__BB__BB__BB__BB__BB__BB__BB__BB__BB__BB__BB__BB__BB__BB__BB__BB__BB__BB__BB
BB__________________________________________________________________________________BB
BB__________________________________________________________________________________BB
BB__BB__BB__BB__BB__BB__BB__BB__BB__BB__BB__BB__BB__BB__BB__BB__BB__BB__BB__BB__BB__BB
BB__________________________________________________________________________________BB
BB__________________________________________________________________________________BB
BB__BB__BB__BB__BB__BB__BB__BB__BB__BB__BB__BB__BB__BB__BB__BB__BB__BB__BB__BB__BB__BB
BB__________________________________________________________________________________BB
BB__________________________________________________________________________________BB
BB__BB__BB__BB__BB__BB__BB__BB__BB__BB__BB__BB__BB__BB__BB__BB__BB__BB__BB__BB__BB__BB
BB__________________________________________________________________________________BB
BB__________________________________________________________________________________BB
BB__BB__BB__BB__BB__BB__BB__BB__BB__BB__BB__BB__BB__BB__BB__BB__BB__BB__BB__BB__BB__BB
BB__________________________________________________________________________________BB
BB__________________________________________________________________________________BB
BB__BB__BB__BB__BB__BB__BB__BB__BB__BB__BB__BB__BB__BB__BB__BB__BB__BB__BB__BB__BB__BB
BB__________________________________________________________________________________BB
BB__________________________________________________________________________________BB
BB__BB__BB__BB__BB__BB__BB__BB__BB__BB__BB__BB__BB__BB__BB__BB__BB__BB__BB__BB__BB__BB
BB__________________________________________________________________________________BB
BB__________________________________________________________________________________BB
BB__BB__BB__BB__BB__BB__BB__BB__BB__BB__BB__BB__BB__BB__BB__BB__BB__BB__BB__BB__BB__BB
BB__________________________________________________________________________________BB
BB__________________________________________________________________________________BB
BB__BB__BB__BB__BB__BB__BB__BB__BB__BB__BB__BB__BB__BB__BB__BB__BB__BB__BB__BB__BB__BB
BB__________________________________________________________________________________BB
BB__________________________________________________________________________________BB
BB__BB__BB__BB__BB__BB__BB__BB__BB__BB__BB__BB__BB__BB__BB__BB__BB__BB__BB__BB__BB__BB
BB__________________________________________________________________________________BB
BB__________________________________________________________________________________BB
BB__BB__BB__BB__BB__BB__BB__BB__BB__BB__BB__BB__BB__BB__BB__BB__BB__BB__BB__BB__BB__BB
BB__________________________________________________________________________________BB
BB__________________________________________________________________________________BB
BB__BB__BB__BB__BB__BB__BB__BB__BB__BB__BB__BB__BB__BB__BB__BB__BB__BB__BB__BB__BB__BB
BB__________________________________________________________________________________BB
BB__________________________________________________________________________________BB
BB__BB__BB__BB__BB__BB__BB__BB__BB__BB__BB__BB__BB__BB__BB__BB__BB__BB__BB__BB__BB__BB
BB__________________________________________________________________________________BB
BB__________________________________________________________________________________BB
BBBBBBBBBBBBBBBBBBBBBBBBBBBBBBBBBBBBBBBBBBBBBBBBBBBBBBBBBBBBBBBBBBBBBBBBBBBBBBBBBBBBBB