______________________T__
_S_______________________
____BBB____BBB____BBB____
____BBB____BBB____BBB____
____BBB____BBB____BBB____
_________________________
_________T_____T_________
_________________________
____BBB____BBB____BBB____
____BBB____BBB____BBB____
____BBB____BBB____BBB____
___________VVV___________
_T_____________________T_
BBBBBBBBBBBHHHBBBBBBBBBBB
BBBBBBBBBBB_T____________
BBBBBBBBBBB____________F_
BBBBBBBBBBB______________