_B_B_B_B_B_B_B_B_B_BB
>___________________B
_S___________T____F_B
>___________________B
_B_B_B_B_B_B_B_B_B_BB