____BB____VVBB______
_S__BB__BB__BB___F__
____BB__BB__BB______
________BB__BB__BBBB
___T____BB__BB__BBBB
BBBBBBBBBB__BB__T___
BBBBBBBBBB__BB^^____
____________BBBBBB__
__________T_BBBBBB__
__BBBBBBBBBBBB______
__BBBBBBBBBBBB______
__________VVBB__BBBB
____________BB__BBBB
BBBBBBBBBB__BB__T___
BBBBBBBBBB__BB^^____
____________BBBBBB__
_____BB_____BBBBBB__
__T__BB_____BB_T____
______________^^____