BBBBBBBBBBB___
BBBBVVVBBBB___
BBBB___BBBB___
BBB4___3BBB___
B>_______<B___
B>___S___<H__3
B>_______<B___
BBB1___2BBB___
BBBB___BBBB___
BBBB^^^BBBB___
BBBBBBBBBBB__T