_B_B_B_B_B_B_B_B_B_BB
>___________________B
_S_______T________F_B
>___________________B
_B_B_B_B_B_B_B_B_B_BB