____BB______________
_S__BB__BB__BB______
____BB__BBVVBB______
________BB__BB__BBBB
___T____BB__BB__BBBB
BBBBBBBBBB__BB______
BBBBBBBBBB__BB______
____________BBBBBB__
__________T_BBBBBB__
__BBBBBBBBBBBB______
__BBBBBBBBBBBB______
____________BB__BBBB
____________BB__BBBB
BBBBBBBBBB__BB______
BBBBBBBBBB__BB______
____________BBBBBB__
_____BB_____BBBBBB__
__T__BB_____BB___F_T
____________HH______