_B_B_B_B_B_B_B_B_B_BB
>___________________B
>S_____T_____T____F_B
>___________________B
_B_B_B_B_B_B_B_B_B_BB