______________________T__
_S_______________________
____BBB____BBB____BBB____
____BBB____BBB____BBB____
____BBB____BBB____BBB____
>________________________
_________T_____T_________
________________________<
____BBB____BBB____BBB____
____BBB____BBB____BBB____
____BBB____BBB____BBB____
___________VVV___________
_T_____________________T_
BBBBBBBBBBBHHHBBBBBBBBBBB
BBBBBBBBBBB_T____________
BBBBBBBBBBB__>>________F_
BBBBBBBBBBB______________