_________________BBBBBBBB_________________
_________________BBBBBBBB_________________
_S__>________T___BBBBBBBB____F____________
___V_____________BBBBBBBB_________________
_________________BBBBBBBB_________________
_________________BBBBBBBBBBBBBBBBBBB______
__________________________________BB___T__
___T_____________>__________T_____BB______
__________________________________BB______
BBBBBBBBBBBBBBBBBBBBBBBBB_________BB______
BBBBBBBBBBBBBBBBBBBBBBBBB_________BB______
__________________________________BB______
___T_____________________________<BB______
_________BBBBBBBBBBBBBBBBBBBBBBBBBBB______
_________BBBBBBBBBBBBBBBBBBBBBBBBBBB___^__
__________________________________________
____>_______________T_____________________
_________BBBBBBBBBBBBBBHHBBBBBBBBBBB______
_________BBBBBBBBBBBBBBHHBBBBBBBBBBB______
____>_______________T_____________________
__________________________________________