_________________BBBBBBBB_________________
_________________BBBBBBBB_________________
_____________T___BBBBBBBB____F____________
_________________BBBBBBBB_________________
_________________BBBBBBBB_________________
_________________BBBBBBBBBBBBBBBBBBB______
__________________________________BB__T___
___T________________________T_____BB______
__________________________________BB______
BBBBBBBBBBBBBBBBBBBBBBBBB_________BB______
BBBBBBBBBBBBBBBBBBBBBBBBB_________BB______
__________________________________BB______
___T______________________________BB______
_________BBBBBBBBBBBBBBBBBBBBBBBBBBB______
_________BBBBBBBBBBBBBBBBBBBBBBBBBBB______
__________________________________________
____________________T_____________________
_________BBBBBBBBBBBBBBBBBBBBBBBBBBB______
_________BBBBBBBBBBBBBBBBBBBBBBBBBBB______
____________________T_____________________
__________________________________________
