_________________BBBBBBBB_________________
____>____________HHHHHHHH_________________
_S__>________T___HHHHHHHH____F____________
__VV_____________BBBBBBBB_________________
_________________BBBBBBBB_________________
_________________BBBBBBBBBBBBBBBBBBB______
_________________>________________BB___T__
___T_____________>__________T_____BB______
_________________>________________BB______
BBBBBBBBBBBBBBBBBBBBBBBBB_________BB______
BBBBBBBBBBBBBBBBBBBBBBBBB_________BB______
__________________________________BB______
___T_____________________________<BB______
_________BBBBBBBBBBBBBBBBBBBBBBBBBBB______
_________BBBBBBBBBBBBBBBBBBBBBBBBBBB___^__
_______________________V__________________
____>_______________T_____________________
_________BBBBBBBBBBBBBBHHBBBBBBBBBBB______
_________BBBBBBBBBBBBBBHHBBBBBBBBBBB______
____>_______________T_____________________
__________________________________________