BBBBBBBBB43BBBBBBBBB
BBBBBBBB4__3BBBBBBBB
BBBBBBB4____3BBBBBBB
BBBBBB4___T__3BBBBBB
BBBBB4________3BBBBB
BBBB4____21____3BBBB
BBB4____2431____3BBB
BB4____24__31____3BB
B4____24____31____3B
4____24____________3
1_S__31__FT______T_2
B1____31____24____2B
BB1____31__24____2BB
BBB1____3124____2BBB
BBBB1____34____2BBBB
BBBBB1________2BBBBB
BBBBBB1___T__2BBBBBB
BBBBBBB1____2BBBBBBB
BBBBBBBB1__2BBBBBBBB
BBBBBBBBB12BBBBBBBBB