_________________BBBBBBBB_________________
_________________BBBBBBBB_________________
___S___V_____T___BBBBBBBB____F____________
_________________BBBBBBBB_________________
_________________BBBBBBBB_________________
_________________BBBBBBBBBBBBBBBBBBB______
__________________________________BB__T___
___T___>____________________T_V___BB______
__________________________________BB______
BBBBBBBBBBBBBBBBBBBBBBBBB_________BB______
BBBBBBBBBBBBBBBBBBBBBBBBB_________BB______
__________________________________BB______
___T_____________________________<BB______
_________BBBBBBBBBBBBBBBBBBBBBBBBBBB______
_________BBBBBBBBBBBBBBBBBBBBBBBBBBB___^__
__________________________________________
____>_______________T_____________________
_________BBBBBBBBBBBBBBBBBBBBBBBBBBB______
_________BBBBBBBBBBBBBBBBBBBBBBBBBBB______
____>_______________T_____________________
__________________________________________
