__BB____________________________BB___
_SBB>_____________T_____________BB_F_
__BB___2BBBBBBBBBBBBBBBBBBBBB1__BB___
__BB___BBBBBBBBBBBBBBBBBBBBBBB__BB___
__BB___BB___________________BB__BB___
__BB___BB_________T________<BB__BB___
__BB___BB__2BBBBBBBBBBBBB1__BB__BB___
__34___BB__BBBBBBBBBBBBBBB__BBT_BB___
_______BB__BB__T___BBBBBBB__34__BB___
__T____BB__BB______BBBBBBB______BB___
BBBBBBBBB__BB__21__BBBBBBB______BB___
BBBBBBBB4__BB__BB__BBBBBBBBBBBBBBB___
_____T_____BB__BB__BBBBBBBBBBBBBB4___
___________BB__BB__BB_____VBB________
__2BBBBBBBBBB__BB__BB______BB______^_
__3BBBBBBBBBB__BB__34__21__BB__BBBBBB
___________BB__BB______BB__BB________
_____T_____BB__BB______BB__BB________
BBBBBBBB1__BB__BBBBBBBBBB__BBBBBBB1__
BBBBBBBB4__BB__3BBBBBBBBB__3BBBBBBB__
___________BB_________BBB________BB__
___________BB_________BBB________BB__
__2BBBBBBBBBBBBBBBB1__BBBBBBBB1__BB__
__3BBBBBBBBBBBBBBBB4__BBBBBBBBB__34__
>_____________________BBBBBBBBB______
>__________T__________BBBBBBBBB___T__