________________
_BB__BB___B__BB_
_BB_______B__BB_
_____________TT_
_____________TT_
_BB______BB__BB_
_BB__BB__BB__BB_
_____BB_________