________________
_BB__BB__BB__BB_
_BB__BB__BB__BB_
_____________TT_
_____________TT_
_BB__BB__BB__BB_
_BB__BB__BB__BB_
________________