_______________________________________
_____________F_________________________
______T________________________________
___BBBHHHBBB___BBBBBBBBB___BBBBBBBBB___
___BBBHHH______BBBBBBBBB___BBBBBBBBB___
___BBBHHHBBB______BBBBBB___BBBBBBBBB___
_______________________________________
_______________________________________
_______________________________________
___BBBBBBBBB___BBBHHHBBB___BBBBBBBBB___
___BBBBBBBBB___BBBHHHBBB___BBBBBBBBB___
___BBBBBBBBB___BBBHHHBBB___BBBBBBBBB___
_______________________________________
_______________________________________
_______________________________________
___BBBBBBBBB___BBBBBBBBB___BBBHHHBBB___
___BBBBBBBBB___BBBBBBBBB___BBBHHHBBB___
___BBBBBBBBB___BBBBBBBBB___BBBHHHBBB___
_______________________________________
_______________________________________
_______________________________________