_______________________________________
_____________F_________________________
_______________________________________
___BBBTTTBBB___BBBBBBBBB___BBBBBBBBB___
___BBBTTTBBB___BBBBBBBBB___BBBBBBBBB___
___BBBTTTBBB___BBBBBBBBB___BBBBBBBBB___
_______________________________________
_______________________________________
_______________________________________
___BBBBBBBBB___BBBTTTBBB___BBBBBBBBB___
___BBBBBBBBB___BBBTTTBBB___BBBBBBBBB___
___BBBBBBBBB___BBBTTTBBB___BBBBBBBBB___
_______________________________________
_______________________________________
_______________________________________
___BBBBBBBBB___BBBBBBBBB___BBBTTTBBB___
___BBBBBBBBB___BBBBBBBBB___BBBTTTBBB___
___BBBBBBBBB___BBBBBBBBB___BBBTTTBBB___
_______________________________________
_______________________________________
_______________________________________