_______________________________________
_____________F_________________________
______T________________________________
___BBBHHHBBBA___BBBBHHBB___BBBBBBBBB___
___BBBHHH_______HHHHHHHH___BBBBBBBBB___
___BBBHHHBBBA_____BBHHBB___BBBBBBBBB___
____________A______T___________________
_______S_______________________________
____________A__________________________
___BBBHHHBBBA__BBBHHHBBB___BBBBBBBBB___
___BBBHHHBBBA__BBBHHHBBB___BBBBBBBBB___
___BBBHHHBBBA__BBBHHHBBB___BBBBBBBBB___
_______________________________________
_______________________________________
_______________________________________
___BBBBBBBBB___BBBBBBBBB___BBBHHHBBB___
___BBBBBBBBB___BBBBBBBBB___BBBHHHBBB___
___BBBBBBBBB___BBBBBBBBB___BBBHHHBBB___
_______________________________________
_______________________________________
_______________________________________