____________________
____________________
___BB__BB___B__BB___
___BB_______B__BB___
_______F_______HH___
_______________HH___
___BB______BB__BB___
___BB__BB__BB__BB___
_______BB___________
____________________
___BHHHB____________
___BHHHB____________
___BHHHB____________
____________________
____________________