____________________
____________________
___BB__BB___B__BB___
___BB_______B__BB___
_______F_______TT___
_______________TT___
___BB______BB__BB___
___BB__BB__BB__BB___
_______BB___________
____________________
___BTTTB____________
___BTTTB____________
___BTTTB____________
____________________
____________________